##############
#>           #          ##############
#            ############            #
#            -          +            #
#            ############            #
#            #          #            #
#            #          #            #
#            #          #            #
#            #          # <          #
##############          ##############
