##############
#>           #          ######
#            ############    #
#            -          +    #
#            ############    #
#            #          #    #
#            #          # <  #
##############          ######